[[' START'], ['------'], ['------'], ['------']] 
[['??????'], ['??????'], ['??????'], ['------']] 
[['??????'], ['??????'], ['??????'], ['------']] 
[['??????'], ['??????'], ['??????'], ['------']] 
[['------'], ['??????'], ['??????'], ['??????']] 
[['------'], ['------'], ['??????'], ['------']] 
[['------'], ['??????'], ['??????'], ['??????']] 
[['------'], ['??????'], ['??????'], ['??????']] 
[['------'], ['------'], ['??????'], ['------']]